0000000000000
0000000000000
0000000000000
0000000000000
1111111111000
2222222222000
0000000000000
0000000000000
0000000000000
0001111111111
0002222222222
0000000000000
0000000000000
0000000000000
1111111111000
2222222222000
0000000000000
0000000000000
