0000000000000
0000000000000
0000000000000
0111110111110
0122210122210
0123210123210
0123210123210
0122210122210
0111110111110
0000000000000
0000000000000
0000000000000
0111110111110
0122210122210
0123210123210
0123210123210
0122210122210
0111110111110
